  a   a   a -
- --------- -
- ---------a-
- --------- -
- ---------a-
-  a a a a  -
- ---------a-
- --------- -
- aaaae     -
-------------
level4.map