 a a2-  ------
 a a2   -    -
 a a2 - -  - -
 a a2 - -  - -
 a a2 - 2aa2 -
 a  g - 2en2 -
 a a2 - 5113 -
 a a2 -      -
 a a2 --------
   a2        -
level6