 -------------
 -------------
 -------------
      a   ----
--- ----- ----
--- ----- ----
--- ----- ----
---   a     e-
--------------
--------------
level2