  a   a   a 2-
- 111111114 2-
- --------2a2-
- --------2a2-
- 111111113a2-
-  a a a a  2-
- 111111114a2-
111111  113 51
-     en    --
--------------
level4