 a a2-  2-----
 a a2   2ea  -
 a a2 - 2    -
 a a2 - -  - -
 a a2 - -  - -
 a  g - -  - -
 a a2 - ---- -
 a a2 -      -
 a a2 --------
   a2        -
level6