           ---
 --------- ---
---------- ---
----a      ---
---------- ---
---------- ---
-----n---- ---
-e         ---
--------------
--------------
level3