  a   a   a 2-
- 111111114 2-
- --------2a2-
- --------2 2-
- 111111113a2-
-  a a a a  2-
- 111111114a2-
11111111113 51
-aaaaaen    --
--------------
level4.map